NO      Textures/quarzo1.png
SO Textures/quarzo2.png
WE   Textures/quarzo3.png
EA            Textures/quarzo4.png

F 255,255,255
C 0,1,0

        1111111111111111111111111
        1000000001100000000000011
        1011000001110000000000001
        1001000000000000000000001
        1111111111111111111111111

111111111111111111111111111111111
111111111011000001110000000000001
100000000011000001110111111111111
11110111111111011100000010001
11110111111111011101010010101
11000000110101011100000010001
10000000000000001100000010001
10000000000000000001010010001
11000001110101011111011110N0111
11110111 1110101 100000000001
11111111 1111111 111111111111