NO Textures/Pableada.png
SO Textures/Pableada.png
WE Textures/Pableada.png
EA Textures/Pableada.png

F 124,124,124
C 255,255,255

111111111
100000001
100000001
100000001
100000001
100000011
10N000001
100000001
100000001
100000001
111111111

