NO ./path_to_the_north_texture
SO ./path_to_the_south_texture
WE ./path_to_the_west_texture
EA ./path_to_the_east_texture

F 220,10,0
C 255,0,240

1111111111111111111111111
1000000000110000000000001
1011000001110000000000001
10010000000000000000000011111111
111111111011000001110000000000001
10000000001100000111011111111111
11110111111111011100000010001        111
11110111111111011101010010001        101
1100000011010101110000S010001        111
10000000000000001100000010001
10000000000000000000000000001
11111111111111111111111111111
1000000000000000110101001000111
1100000111010101111101111000111
11110111 1110101 101111010001
11111111 1111111 111111111111
